1 7
10 10
%%%%%%%%%%
%M-------%
%-----%--%
%MM---%%%%
%--------%
%-MM----M%
%---%%--%%
%-MMM----%
%-------M%
%%%%%%%%%%