2 3
5 5
%%%%%
%M--%
%---%
%MM-%
%%%%%
