2 3
7 7
%%%%%%%
%%----%
%-----%
%%%%--%
%-----%
%-----%
%%%%%%%